(U)
T @ 10 10 50 30
A $ 50 300 40 40 30
A - 10 200 40 40 10
A a 10 80 40 40 10
A b 10 80 40 40 10
M % 20 20 3 30
R * 20 20 3
R ? 20 80 3

(W)
0 2 20 200
[        ]
[        ]

(M)
11 29 (100 100) 10
#############################
1    #         #            #
# ## #  #####  #  #######   #
# #  #      #     # #       #
# ######### ####  # #    ####
#  #      #    #    #    #  #
##     ####    ######    #  #
#    ###     #   #          #
#        #   #####    #######
2        #     #            #
#####################O#######