(U)
T @ 40 90 80 30
A $ 20 80 60 40 90
M % 20 20 30 60
R * 20 20

(W)
0 50 300
[        ]

(M)
11 29 (300 300)
#############################
1    #         #            #
# ## #  #%###  #  #######   #
# #  #      #     # #       #
# ######### ##*#  # #    ####
#  #      #    #    #    #  #
##     ####    ######    #  #
#    ###     #   #          #
#        #   #####    #######
#        #     #            #
#####################O#######
