(U)
T @ 10 50 30;
A $ 80 40 40 90;
A - 80 40 40 90;
A a 80 40 40 90;
A b 80 40 40 90;
M % 20 20 30 60;
R * 20 20;
R ? 80 80;

(W)
0
[     ]
[     ]

(M)
11 29 (100 100);
#############################
1    #         #            #
# ## #  #####  #  #######   #
# #  #      #     # #       #
# ######### ####  # #    ####
#  #      #    #    #    #  #
##     ####    ######    #  #
#    ###     #   #          #
#        #   #####    #######
2        #     #            #
#####################O#######