6,10
##########
#        #
#        #
#        #
#        O
##########
