11,29
#############################
1    #         #            #
# ## #  #%###  #  #######   #
# #  #      #     # #       #
# ######### ##*#  # #    ####
#  #      #    #    #    #  #
##     ####    ######    #  #
#    ###     #   #          #
#        #   #####    #######
#        #     #            #
#####################O#######
