(U)
T @ 10 50 100 30
T \ 20 100 50 80
A $ 30 200 20 50 20
A - 30 400 40 50 20
A a 50 500 20 50 50
A b 100 200 40 40 40
M % 20 20 3 30
M ' 20 10 5 10
R * 20 20 3
R ? 40 80 3
R ; 20 20 5

(M)
25 73 (100 100) 10
###################################2#################3###################
#   #               #                   #                   #           #
#   #   #####   #   #   #####   #   #####   #########   #   #####   #   #
#   #   #   #   #   #   #   #   #   #       #       #   #           #   #
#   #   #   #   #####   #   #   #   #   #####   #   #   #############   #
#       #   #   #       #   #   #       #       #       #       #       #
#   #####   #   #   #####   #############   #############   #   #   #####
#   #       #       #   #               #   #           #   #           #
#   #####   #########   #############   #   #   #####   #############   #
#               #       #   #           #   #       #   #       #   #   #
#############   #   #   #   #   #########   #####   #   #   #   #   #   #
#       #   #       #       #   #           #       #       #   #       #
#   #   #   #########   #####   #   #########   #############   #########
#   #       #           #       #               #           #           #
#   #####   #   #########   #####################   #####   #   #####   #
#       #   #   #       #                       #   #       #       #   #
#####   #   #   #####   #####################   #   #   #############   #
#       #   #                   #   #           #   #           #       O
#   #####   #################   #   #   #########   #########   #   #   #
#   #       #       #   #       #   #       #               #       #   #
#   #####   #   #   #   #   #####   #####   #####   #####   #########   #
#       #       #       #           #   #       #       #       #   #   #
#   #   #########################   #   #####   #############   #   #   #
#   #                                       #                   #       #
################1########################################################

(W)
0 3 20 800
[         ]
[         ]
[         ]


source: https://github.com/boppreh/maze
